111111111111111
1000001C1000001
100000100011101
100000111111101
100000000000001
101111111111111
101100000100001
1000011101P1101
100001000111101
111101011100001
100001000001101
100111111111111
1000000000000E1
111111111111111