1111111111111111111111111111
1111111111111111111111111111111
111111111111111111111111111111
100000000000000000000000CP000E11
1111111111111111111111111111111
1111111111111111111111111111