11111111111111111111111111111
11111111111111111111111111111
1P0000000CCCC00000E0000000011
11111111111111111111111111111
11111111111111111111111111111