11111111111111111111111
10000000000000000000001
100000000000000000000P1
10000000000000000000001
10000000000000000000001
10000000000000000000001
11111111111111111110111
1CC00000000000000000001
1EC00000000000000000001
10000011110000000000001
11111111111111111111111